{
  "1": "1",
  "2": "2",
  "3": "3",
  "4": "4",
  "5": "5",
  "6": "6",
  "7": "7",
  "8": "8",
  "9": "9",
  "0": "0",
  "-": "-",
  "=": "=",
  "q": "ஆ",
  "w": "ஈ",
  "e": "ஊ",
  "r": "ஐ",
  "t": "ஏ",
  "y": "ள",
  "u": "ற",
  "i": "ன",
  "o": "ட",
  "p": "ண",
  "[": "ச",
  "]": "ஞ",
  "\\": "\\",
  "a": "அ",
  "s": "இ",
  "d": "உ",
  "f": "்",
  "g": "எ",
  "h": "க",
  "j": "ப",
  "k": "ம",
  "l": "த",
  ";": "ந",
  "'": "ய",
  "z": "ஔ",
  "x": "ஓ",
  "c": "ஒ",
  "v": "வ",
  "b": "ங",
  "n": "ல",
  "m": "ர",
  ",": ",",
  ".": ".",
  "/": "ழ",
  "!": "!",
  "@": "@",
  "#": "#",
  "$": "$",
  "%": "%",
  "^": "^",
  "&": "&",
  "*": "*",
  "(": "(",
  ")": ")",
  "_": "_",
  "+": "+",
  "Q": "ஸ",
  "W": "ஷ",
  "E": "ஜ",
  "R": "ஹ",
  "T": "க்ஷ",
  "Y": "ஸ்ரீ",
  "U": "ஶ",
  "I": "ஈ",
  "O": "[",
  "P": "]",
  "{": "{",
  "}": "}",
  "|": "|",
  "A": "௹",
  "S": "௺",
  "D": "௸",
  "F": "ஃ",
  "G": "",
  "H": "",
  "J": "",
  "K": "\"",
  "L": ":",
  ":": ";",
  "\"": "'",
  "Z": "௳",
  "X": "௴",
  "C": "௵",
  "V": "௶",
  "B": "௷",
  "N": "",
  "M": "/",
  "<": "<",
  ">": ">",
  "?": "?"
}
